+--+--+--+--+--+--+--+--+--+--+
|        |        |           |
+--+  +  +  +--+  +  +  +--+  +
|  |  |  |  |  |     |  |  |  |
+  +  +  +  +  +--+--+  +  +  +
|     |                 |     |
+  +--+--+--+  +--+  +--+--+--+
|  |              |           |
+  +--+  +  +--+  +--+--+--+  +
|        |                    |
+--+--+--+--+--+--+--+--+--+--+